"aE" = (/turf/closed/wall/mineral/titanium,/area/shuttle/escape/brig)
"aS" = (/turf/open/floor/plating,/area/shuttle/escape)
"cn" = (/obj/machinery/computer/med_data,/turf/open/floor/wood,/area/shuttle/escape)
"cD" = (/obj/docking_port/mobile/emergency,/obj/machinery/door/airlock/shuttle/glass,/turf/open/floor/mineral/titanium/white,/area/shuttle/escape)
"cE" = (/obj/machinery/computer/atmos_alert,/turf/open/floor/wood,/area/shuttle/escape)
"dI" = (/obj/machinery/computer/emergency_shuttle,/turf/open/floor/wood,/area/shuttle/escape)
"ek" = (/turf/open/floor/mineral/titanium/white,/area/shuttle/escape)
"eI" = (/obj/machinery/computer/operating{dir = 8},/turf/open/floor/mineral/titanium/white,/area/shuttle/escape)
"fz" = (/obj/machinery/computer/communications,/turf/open/floor/wood,/area/shuttle/escape)
"hW" = (/obj/structure/chair/comfy/shuttle{dir = 8},/turf/open/floor/glass/reinforced,/area/shuttle/escape)
"iM" = (/obj/structure/closet/toolcloset,/turf/open/floor/plating,/area/shuttle/escape)
"jm" = (/obj/structure/table/reinforced,/obj/item/tank/jetpack/carbondioxide{pixel_x = -7; pixel_y = -7},/obj/item/tank/jetpack/carbondioxide,/obj/item/tank/jetpack/carbondioxide{pixel_x = 7; pixel_y = 7},/turf/open/floor/mineral/titanium/white,/area/shuttle/escape)
"lW" = (/turf/template_noop,/area/shuttle/escape)
"lX" = (/obj/machinery/door/airlock/command{name = "Emergency Recovery Airlock"; req_access_txt = "19"},/turf/open/floor/mineral/titanium/white,/area/shuttle/escape)
"ml" = (/obj/machinery/computer/crew,/turf/open/floor/wood,/area/shuttle/escape)
"oD" = (/obj/machinery/door/airlock/shuttle/glass,/turf/open/floor/mineral/titanium/white,/area/shuttle/escape)
"sm" = (/turf/template_noop,/area/template_noop)
"uk" = (/obj/machinery/computer/operating{dir = 4},/turf/open/floor/mineral/titanium/white,/area/shuttle/escape)
"vv" = (/obj/structure/table/reinforced,/turf/open/floor/mineral/titanium/white,/area/shuttle/escape)
"ws" = (/obj/item/clothing/suit/hazardvest{desc = "A high-visibility lifejacket complete with whistle and slot for oxygen tanks."; name = "emergency lifejacket"},/obj/item/clothing/suit/hazardvest{desc = "A high-visibility lifejacket complete with whistle and slot for oxygen tanks."; name = "emergency lifejacket"},/obj/item/clothing/suit/hazardvest{desc = "A high-visibility lifejacket complete with whistle and slot for oxygen tanks."; name = "emergency lifejacket"},/obj/item/clothing/suit/hazardvest{desc = "A high-visibility lifejacket complete with whistle and slot for oxygen tanks."; name = "emergency lifejacket"},/obj/item/clothing/suit/hazardvest{desc = "A high-visibility lifejacket complete with whistle and slot for oxygen tanks."; name = "emergency lifejacket"},/obj/item/tank/internals/emergency_oxygen{pixel_x = 3},/obj/item/tank/internals/emergency_oxygen{pixel_x = 3},/obj/item/tank/internals/emergency_oxygen{pixel_x = 3},/obj/item/tank/internals/emergency_oxygen{pixel_x = 3},/obj/item/tank/internals/emergency_oxygen{pixel_x = 3},/obj/item/clothing/mask/breath{pixel_x = -3; pixel_y = -3},/obj/item/clothing/mask/breath{pixel_x = -3; pixel_y = -3},/obj/item/clothing/mask/breath{pixel_x = -3; pixel_y = -3},/obj/item/clothing/mask/breath{pixel_x = -3; pixel_y = -3},/obj/item/clothing/mask/breath{pixel_x = -3; pixel_y = -3},/obj/item/clothing/head/hardhat/orange{name = "protective hat"; pixel_y = 9},/obj/item/clothing/head/hardhat/orange{name = "protective hat"; pixel_y = 9},/obj/item/clothing/head/hardhat/orange{name = "protective hat"; pixel_y = 9},/obj/item/clothing/head/hardhat/orange{name = "protective hat"; pixel_y = 9},/obj/item/clothing/head/hardhat/orange{name = "protective hat"; pixel_y = 9},/obj/structure/closet/crate/internals,/obj/effect/turf_decal/bot,/turf/open/floor/mineral/titanium/white,/area/shuttle/escape)
"wS" = (/obj/machinery/suit_storage_unit/standard_unit,/turf/open/floor/mineral/titanium/white,/area/shuttle/escape)
"xB" = (/obj/machinery/door/airlock/command/glass{name = "Cockpit"; req_access_txt = "19"},/turf/open/floor/wood,/area/shuttle/escape)
"xD" = (/turf/open/floor/wood,/area/shuttle/escape/brig)
"yk" = (/obj/machinery/door/airlock/security/glass{name = "Holding Area"; req_access_txt = "2"},/turf/open/floor/wood,/area/shuttle/escape/brig)
"yw" = (/obj/structure/chair/comfy/shuttle{dir = 4},/turf/open/floor/glass/reinforced,/area/shuttle/escape)
"Av" = (/obj/structure/tank_dispenser/oxygen,/turf/open/floor/mineral/titanium/white,/area/shuttle/escape)
"AG" = (/obj/structure/chair/comfy/shuttle,/turf/open/floor/wood,/area/shuttle/escape/brig)
"BX" = (/obj/machinery/stasis,/turf/open/floor/mineral/titanium/white,/area/shuttle/escape)
"Cv" = (/obj/structure/shuttle/engine/huge,/turf/template_noop,/area/shuttle/escape)
"Eg" = (/obj/machinery/computer/security,/turf/open/floor/wood,/area/shuttle/escape)
"EL" = (/obj/structure/closet/emcloset,/turf/open/floor/plating,/area/shuttle/escape)
"ES" = (/obj/structure/chair/comfy/shuttle{dir = 4},/turf/open/floor/wood,/area/shuttle/escape/brig)
"Fj" = (/obj/structure/closet/crate/medical,/turf/open/floor/mineral/titanium/white,/area/shuttle/escape)
"Gc" = (/obj/structure/chair/comfy/shuttle{dir = 8},/turf/open/floor/wood,/area/shuttle/escape/brig)
"GI" = (/obj/structure/chair/comfy/shuttle{dir = 1},/turf/open/floor/glass/reinforced,/area/shuttle/escape)
"Ih" = (/obj/structure/window/shuttle,/turf/open/floor/plating,/area/shuttle/escape)
"Jn" = (/obj/machinery/door/airlock/external{name = "Emergency Recovery Airlock"},/turf/open/floor/mineral/titanium/white,/area/shuttle/escape)
"Mb" = (/turf/closed/wall/mineral/titanium,/area/shuttle/escape)
"Mr" = (/obj/structure/table/reinforced,/obj/item/tank/jetpack/carbondioxide{pixel_x = 7; pixel_y = -7},/obj/item/tank/jetpack/carbondioxide,/obj/item/tank/jetpack/carbondioxide{pixel_x = -7; pixel_y = 7},/turf/open/floor/mineral/titanium/white,/area/shuttle/escape)
"MY" = (/obj/structure/chair/office{dir = 1},/turf/open/floor/wood,/area/shuttle/escape)
"PM" = (/obj/structure/table/wood,/turf/open/floor/wood,/area/shuttle/escape/brig)
"Qg" = (/obj/structure/chair/comfy/shuttle,/turf/open/floor/glass/reinforced,/area/shuttle/escape)
"Rw" = (/obj/structure/shuttle/engine/large,/turf/template_noop,/area/shuttle/escape)
"RR" = (/obj/machinery/computer/secure_data,/turf/open/floor/wood,/area/shuttle/escape)
"RZ" = (/obj/structure/table/optable,/turf/open/floor/mineral/titanium/white,/area/shuttle/escape)
"Ti" = (/obj/structure/table/reinforced,/obj/item/extinguisher{pixel_x = -5},/obj/item/extinguisher{pixel_x = 5},/turf/open/floor/mineral/titanium/white,/area/shuttle/escape)
"TG" = (/obj/machinery/door/airlock/shuttle{name = "Emergency Shuttle Airlock"},/turf/open/floor/mineral/titanium/white,/area/shuttle/escape)
"TT" = (/obj/structure/closet/firecloset,/turf/open/floor/plating,/area/shuttle/escape)
"Ux" = (/obj/structure/closet/crate/engineering,/turf/open/floor/plating,/area/shuttle/escape)
"UK" = (/obj/structure/table/reinforced,/turf/open/floor/wood,/area/shuttle/escape)
"UP" = (/obj/machinery/door/airlock/medical/glass{name = "Escape Shuttle Infirmary"},/turf/open/floor/mineral/titanium/white,/area/shuttle/escape)
"VL" = (/obj/structure/closet/firecloset,/turf/open/floor/mineral/titanium/white,/area/shuttle/escape)
"Wb" = (/obj/machinery/computer/station_alert,/turf/open/floor/wood,/area/shuttle/escape)
"Xn" = (/obj/structure/closet/emcloset,/turf/open/floor/mineral/titanium/white,/area/shuttle/escape)
"Xy" = (/turf/open/floor/wood,/area/shuttle/escape)

(1,1,1) = {"
smsmsmsmsmsmsmsmsmsmsmIhIhIhIhIhIhIhsmsmsmsmsmsmsmsmsmsmsm
smsmsmsmsmsmsmsmIhIhIhIhmlcnUKdIfzIhIhIhIhsmsmsmsmsmsmsmsm
smsmsmsmsmsmMbMbIhRRUKEgMYMYXyMYMYcEUKWbIhIhMbsmsmsmsmsmsm
smsmsmsmsmMbMbXyUKMYXyMYXyXyXyXyXyMYXyMYXyXyMbMbsmsmsmsmsm
smsmsmsmMbMbXyXyXyUKUKUKXyXyXyXyXyXyXyXyXyXyXyMbMbsmsmsmsm
smsmsmMbMbXyXyXyXyXyXyXyXyXyXyXyXyXyXyXyXyXyXyXyMbMbsmsmsm
smsmaEaEaEykaEaEaEaEaEaEaEXyXyXyMbMbMbMbMblXMbMbMbMbMbsmsm
smsmaExDxDxDaExDAGAGAGxDaEXyXyXyMbAvwSwSwSekekekekwsMbsmsm
smaEaExDxDxDaEESPMPMPMGcaExBMbxBMbekekekekekekekekMbMbMbsm
smaExDxDxDxDaEESPMPMPMGcaEXyXyXyMbekekekekekekekekJnekJnsm
smaExDxDxDxDaEESPMPMPMGcaEXyXyXyMbTiwSwSwSjmMrXnVLMbMbMbsm
MbaEaEaEaEykaEESPMPMPMGcaExBMbxBMbMbMbMbMbMbMbMbMbMbMbMbMb
IhXyXyXyXyXyXyXyXyXyXyXyXyXyXyXyXyXyXyXyXyXyXyXyXyXyXyXyIh
oDXyXyXyGIXyXyXyGIXyXyXyGIXyXyXyGIXyXyXyGIXyXyXyGIXyXyXyIh
cDXyXyhWMbywXyhWMbywXyhWMbywXyhWMbywXyhWMbywXyhWMbywXyXyIh
oDXyXyhWIhywXyhWIhywXyhWIhywXyhWIhywXyhWIhywXyhWIhywXyXyIh
IhXyXyhWIhywXyhWIhywXyhWIhywXyhWIhywXyhWIhywXyhWIhywXyXyIh
MbMbXyhWMbywXyhWMbywXyhWMbywXyhWMbywXyhWMbywXyhWMbywXyMbMb
smMbXyXyQgXyXyXyQgXyXyXyQgXyXyXyQgXyXyXyQgXyXyXyQgXyXyMbsm
smMbXyXyXyXyXyXyXyXyXyXyXyXyXyXyXyXyXyXyXyXyXyXyXyXyXyMbsm
smMbMbMbMbTGMbMbMbMbMbMbMbMbUPMbMbMbMbMbMbMbMbTGMbMbMbMbsm
smsmMbTTaSaSaSaSMbMbBXBXekekekekekBXBXMbMbaSaSaSaSTTMbsmsm
smMbMbTTaSaSiMMbMbBXekekekekekekekekekBXMbMbiMaSaSTTMbMbsm
MbMbELaSaSUxMbMbBXekekekRZeIekukRZekekekBXMbMbUxaSaSELMbMb
MbIhIhIhIhIhMbMbBXekekekekvvekvvekekekekBXMbMbIhIhIhIhIhMb
aSaSaSaSaSaSaSMbBXekekekRZeIekukRZekekekBXMbaSaSaSaSaSaSaS
RwlWaSaSaSRwlWIhIhBXBXekekekekekekekBXBXIhIhRwlWaSaSaSRwlW
smsmCvlWlWsmsmsmIhIhIhIhvvvvFjvvvvIhIhIhIhsmsmsmCvlWlWsmsm
smsmsmsmsmsmsmsmsmsmsmIhIhIhIhIhIhIhsmsmsmsmsmsmsmsmsmsmsm
"}
