"a" = (/turf/closed/wall/mineral/titanium,/area/shuttle/labor)
"c" = (/obj/machinery/mineral/labor_claim_console{machinedir = 1; pixel_x = 30},/obj/effect/decal/cleanable/dirt,/obj/effect/turf_decal/stripes/line{dir = 5},/turf/open/floor/iron,/area/shuttle/labor)
"g" = (/obj/machinery/mineral/stacking_machine/laborstacker{input_dir = 2; output_dir = 1},/obj/effect/turf_decal/stripes/line,/turf/open/floor/iron/white,/area/shuttle/labor)
"h" = (/obj/item/folder/red,/obj/item/restraints/handcuffs,/obj/structure/table/reinforced,/turf/open/floor/mineral/plastitanium/red,/area/shuttle/labor)
"j" = (/obj/structure/shuttle/engine/heater,/obj/structure/window/reinforced{dir = 1; layer = 2.9},/obj/effect/turf_decal/stripes/line,/turf/open/floor/plating/airless,/area/shuttle/labor)
"l" = (/obj/machinery/door/airlock/shuttle{name = "Labor Shuttle Airlock"; req_access_txt = "2"},/obj/effect/turf_decal/stripes/line{dir = 8},/obj/effect/turf_decal/stripes/line{dir = 4},/turf/open/floor/plating,/area/shuttle/labor)
"m" = (/obj/machinery/door/airlock/shuttle{name = "Labor Shuttle Airlock"; req_access_txt = "2"},/obj/effect/turf_decal/stripes/line,/turf/open/floor/iron/white,/area/shuttle/labor)
"n" = (/obj/structure/chair/comfy/shuttle{dir = 4},/obj/effect/turf_decal/stripes/line{dir = 10},/turf/open/floor/iron,/area/shuttle/labor)
"p" = (/obj/structure/cable,/obj/effect/spawner/structure/window/shuttle,/turf/open/floor/plating,/area/shuttle/labor)
"r" = (/obj/machinery/mineral/stacking_unit_console{machinedir = 2; pixel_x = 30; pixel_y = 30},/turf/open/floor/mineral/plastitanium/red,/area/shuttle/labor)
"v" = (/obj/effect/decal/cleanable/dirt,/obj/effect/turf_decal/stripes/line{dir = 1},/obj/machinery/light/directional/north,/turf/open/floor/iron,/area/shuttle/labor)
"y" = (/obj/structure/chair/office{dir = 1},/turf/open/floor/mineral/plastitanium/red,/area/shuttle/labor)
"z" = (/obj/machinery/door/airlock/shuttle{id_tag = "prisonshuttle"; name = "Labor Shuttle Airlock"},/obj/docking_port/mobile{dir = 8; dwidth = 2; height = 5; id = "laborcamp"; name = "labor camp shuttle"; port_direction = 4; width = 9},/obj/effect/turf_decal/stripes/line{dir = 8},/obj/effect/turf_decal/stripes/line{dir = 4},/turf/open/floor/plating,/area/shuttle/labor)
"B" = (/obj/structure/shuttle/engine/propulsion,/obj/effect/turf_decal/stripes/line,/turf/open/floor/plating/airless,/area/shuttle/labor)
"C" = (/obj/item/clothing/suit/hazardvest{desc = "A high-visibility lifejacket complete with whistle and slot for oxygen tanks."; name = "emergency lifejacket"},/obj/item/clothing/suit/hazardvest{desc = "A high-visibility lifejacket complete with whistle and slot for oxygen tanks."; name = "emergency lifejacket"},/obj/item/clothing/suit/hazardvest{desc = "A high-visibility lifejacket complete with whistle and slot for oxygen tanks."; name = "emergency lifejacket"},/obj/item/clothing/suit/hazardvest{desc = "A high-visibility lifejacket complete with whistle and slot for oxygen tanks."; name = "emergency lifejacket"},/obj/item/clothing/suit/hazardvest{desc = "A high-visibility lifejacket complete with whistle and slot for oxygen tanks."; name = "emergency lifejacket"},/obj/item/tank/internals/emergency_oxygen{pixel_x = 3},/obj/item/tank/internals/emergency_oxygen{pixel_x = 3},/obj/item/tank/internals/emergency_oxygen{pixel_x = 3},/obj/item/tank/internals/emergency_oxygen{pixel_x = 3},/obj/item/tank/internals/emergency_oxygen{pixel_x = 3},/obj/item/clothing/mask/breath{pixel_x = -3; pixel_y = -3},/obj/item/clothing/mask/breath{pixel_x = -3; pixel_y = -3},/obj/item/clothing/mask/breath{pixel_x = -3; pixel_y = -3},/obj/item/clothing/mask/breath{pixel_x = -3; pixel_y = -3},/obj/item/clothing/mask/breath{pixel_x = -3; pixel_y = -3},/obj/item/clothing/head/hardhat/orange{name = "protective hat"; pixel_y = 9},/obj/item/clothing/head/hardhat/orange{name = "protective hat"; pixel_y = 9},/obj/item/clothing/head/hardhat/orange{name = "protective hat"; pixel_y = 9},/obj/item/clothing/head/hardhat/orange{name = "protective hat"; pixel_y = 9},/obj/item/clothing/head/hardhat/orange{name = "protective hat"; pixel_y = 9},/obj/structure/closet/crate/internals,/obj/effect/decal/cleanable/dirt,/obj/effect/turf_decal/delivery,/turf/open/floor/iron,/area/shuttle/labor)
"D" = (/obj/machinery/button/flasher{id = "gulagshuttleflasher"; name = "Flash Control"; pixel_y = -26; req_access_txt = "1"},/obj/machinery/light/directional/south,/turf/open/floor/mineral/plastitanium/red,/area/shuttle/labor)
"E" = (/obj/effect/turf_decal/bot,/turf/open/floor/iron,/area/shuttle/labor)
"J" = (/obj/effect/turf_decal/stripes/line,/turf/open/floor/iron,/area/shuttle/labor)
"K" = (/turf/open/floor/mineral/plastitanium/red,/area/shuttle/labor)
"O" = (/obj/structure/chair/comfy/shuttle{dir = 8},/obj/machinery/flasher/directional/east{id = "gulagshuttleflasher"},/obj/effect/turf_decal/stripes/line{dir = 6},/turf/open/floor/iron,/area/shuttle/labor)
"Q" = (/obj/machinery/computer/shuttle/labor{dir = 4; possible_destinations = "laborcamp_home;laborcamp_away;laborcamp_courtroom"},/obj/structure/reagent_dispensers/peppertank/directional/west,/turf/open/floor/mineral/plastitanium/red,/area/shuttle/labor)
"R" = (/obj/effect/turf_decal/stripes/line{dir = 9},/turf/open/floor/iron,/area/shuttle/labor)
"T" = (/turf/closed/wall/mineral/titanium/nodiagonal,/area/shuttle/labor)
"X" = (/obj/effect/decal/cleanable/dirt,/obj/effect/turf_decal/bot,/turf/open/floor/iron,/area/shuttle/labor)
"Z" = (/obj/effect/spawner/structure/window/shuttle,/turf/open/floor/plating,/area/shuttle/labor)

(1,1,1) = {"
aZZZa
aQyha
pKDrl
amTga
aRvca
pnJOa
aCXEz
aajaa
aBBBa
"}
